A#################################
.................................#
################################.#
#..............................#.#
#.############################.#.#
#.#..........................#.#.#
#.#.########################.#.#.#
#.#.#B######################.#.#.#
#.#.#........................#.#.#
#.#.##########################.#.#
#.#............................#.#
#.##############################.#
#................................#
##################################
