A#############################################
.............................................#
############################################.#
#..........................................#.#
#.########################################.#.#
#.#......................................#.#.#
#.#.####################################.#.#.#
#.#.#B##################################.#.#.#
#.#.#....................................#.#.#
#.#.######################################.#.#
#.#........................................#.#
#.##########################################.#
#............................................#
##############################################
