     A#####################
    #.########............##
   ##.########.##########.###
  ###.....####.#........#.####
 ########.####.#.######.#.#####
 ########.####.#.#.####.#.#####
 ########..###.#.#......#.#####
  ########.###.#.########.####
   #######..##.#..........###
    #######.##.#############
     ######...............#
      ###################B
