#################################
A.......################....#####
###..#############.#####.########
####.#############.#####.########
####...............#####.###....B
####.###################.###.####
####....################.###.####
#######.################.###..###
#######.################.###..###
#######.......................###
#################################
