#################################
A.......################....#####
####.#############.#####.########
####.#############.#####.########
####...............#####.####...B
####.###################.####.###
####....################.####.###
#######.################.####.###
#######..###############.####.###
#######.......................###
#################################
