#################################
1.......################....#####
###..#############.#####.########
####.#############.#####.########
####...............#####.###....2
####.###################.###.####
####....################.###.####
#######.################.###..###
#######.################.###..###
#######.......................###
#################################
