#################################
A.......################....#####
####.#############.#####.########
####.#############.#####.########
####.#.............#####.####...B
####.###################.####.###
####....################.####.###
#######.################.####.###
#######..####################.###
#######.......................###
#################################
